*    *        *      *                    *    *               *          *  *      
*    *  ***   *      *       ***          *    *  ***    ***   *          *  *      
****** *   *  *      *      *   *         *    * *   *  *      *       ****  *      
*    * ****   *      *      *   *         *    * *   *  *      *      *   *  *      
*    * *      *      *      *   *         * ** * *   *  *      *      *   *         
*    *  ****   **     **     ***           *  *   ***   *       **     ****  *      
                                                                                    